
{
    "width": 5,
    "length" : 5,
    "height" : 5,
   
    "layers":
    [
         [
            ["01","01","01","01","01"],
            ["00","00","00","00","01"],
            ["01","01","01","01","01"],
            ["01","00","00","00","00"],
            ["00","00","00","00","00"]
         ],
         [
            ["00","00","00","00","00"],
            ["00","00","00","00","00"],
            ["11","03","00","00","00"],
            ["11","00","00","00","11"],
            ["11","11","11","11","11"]
         ]
     ]
}